FAR1	Plasmalogen synthesis
FAR2	Plasmalogen synthesis
GNPAT	Plasmalogen synthesis
AGPS	Plasmalogen synthesis
LPCAT1	Lipid remodelling
LPCAT2	Lipid remodelling
LPCAT3	Lipid remodelling
LPCAT4	Lipid remodelling
SPTLC1	Ceramide metabolism
SPTLC2	Ceramide metabolism
SPTLC3	Ceramide metabolism
CERS1	Ceramide metabolism
CERS2	Ceramide metabolism
CERS3	Ceramide metabolism
CERS4	Ceramide metabolism
CERS5	Ceramide metabolism
CERS6	Ceramide metabolism
DEGS1	Ceramide metabolism
DEGS2	Ceramide metabolism
CERK	Ceramide metabolism
SPHK1	Ceramide metabolism
SPHK2	Ceramide metabolism
SGPP1	Ceramide metabolism
SGPP2	Ceramide metabolism
SGMS1	Ceramide metabolism
SGMS2	Ceramide metabolism
SMPD1	Ceramide metabolism
SMPD2	Ceramide metabolism
SMPD3	Ceramide metabolism
SMPD4	Ceramide metabolism
ACER1	Ceramide metabolism
ACER2	Ceramide metabolism
ACER3	Ceramide metabolism
ASAH1	Ceramide metabolism
ASAH2	Ceramide metabolism
UGCG	Glycosphingolipid metabolism
GBA	Glycosphingolipid metabolism
GBA2	Glycosphingolipid metabolism
B4GALT5	Glycosphingolipid metabolism
B4GALT6	Glycosphingolipid metabolism
ARSA	Glycosphingolipid metabolism
GAL3ST1	Glycosphingolipid metabolism
A4GALT	Glycosphingolipid metabolism
GBGT1	Glycosphingolipid metabolism
B3GALNT1	Glycosphingolipid metabolism
ST8SIA1	Glycosphingolipid metabolism
B3GALT4	Glycosphingolipid metabolism
B4GALNT1	Glycosphingolipid metabolism
ST3GAL2	Glycosphingolipid metabolism
ST3GAL4	Glycosphingolipid metabolism
B3GNT5	Glycosphingolipid metabolism
GLA	Glycosphingolipid metabolism
HEXA	Glycosphingolipid metabolism
HEXB	Glycosphingolipid metabolism
NEU1	Glycosphingolipid metabolism
NEU3	Glycosphingolipid metabolism
NEU4	Glycosphingolipid metabolism
